{ 
    "rotationLayer": [
        10,10,10,10,10,10,10,10,10,10,10,10,10,10,10,10,10,10,10,10,10,10,10,10,10,10,10,10,10,10,10,10,10,10,10,10,
        10,10,10,10,10,10,10,10,10,10,10,10,10,10,10,10,10,10,10,10,10,10,10,10,10,10,10,10,10,10,10,10,10,10,10,10,
        10,10,10,10,10,10,10,10,10,10,10,10,10,10,10,10,10,10,10,10,10,10,10,10,10,10,10,10,10,10,10,10,10,10,10,10,
        10,10,10,10,10,10,10,10,10,10,10,10,10,10,10,10,10,10,10,10,10,10,10,10,10,10,10,10,10,10,10,10,10,10,10,10,
        10,10,10,10,10,10,10,10,10,10,10,10,10,10,10,10,10,10,10,10,10,10,10,10,10,10,10,10,10,10,10,10,10,10,10,10,
        10,10,10,10,10,10,10,10,10,10,10,10,10,10,10,10,10,10,10,10,10,10,10,10,10,10,10,10,10,10,10,10,10,10,10,10,
        10,10,10,10,10,10,10,10,10,10,10,10,10,10,10,10,10,10,10,10,10,10,10,10,10,10,10,10,10,10,10,10,10,10,10,10,
        10,10,10,10,10,10,10,10,10,10,10,10,10,10,10,10,10,10,10,10,10,10,10,10,10,10,10,10,10,10,10,10,10,10,10,10,
        10,10,10,10,10,10,10,10,10,10,10,10,10,10,10,10,10,10,10,10,10,10,10,10,10,10,10,10,10,10,10,10,10,10,10,10,
        10,10,10,10,10,10,10,10,10,10,10,10,10,10,10,10,10,10,10,10,10,10,10,10,10,10,10,10,10,10,10,10,10,10,10,10,
        10,10,10,10,10,10,10,10,10,10,10,10,10,10,10,10,10,10,10,10,10,10,10,10,10,10,10,10,10,10,10,10,10,10,10,10,
        10,10,10,10,10,10,10,10,10,10,10,10,10,10,10,10,10,10,10,10,10,10,10,10,10,10,10,10,10,10,10,10,10,10,10,10,
        10,10,10,10,10,10,10,10,10,10,10,10,10,10,10,10,10,10,10,10,10,10,10,10,10,10,10,10,10,10,10,10,10,10,10,10,
        10,10,10,10,10,10,10,10,10,10,10,10,10,10,10,10,10,10,10,10,10,10,10,10,10,10,10,10,10,10,10,10,10,10,10,10,
        10,10,10,10,10,10,10,10,10,10,10,10,10,10,10,10,10,10,10,10,10,10,10,10,10,10,10,10,10,10,10,10,10,10,10,10,
        10,10,10,10,10,10,10,10,10,10,10,10,10,10,10,10,10,10,10,10,10,10,10,10,10,10,10,10,10,10,10,10,10,10,10,10
    ],
    "tileLayer": [
        11,11,11,11,11,11,11,11,11,11,11,11,11,11,11,11,11,11,11,11,11,11,11,11,
        11,11,11,11,11,11,11,11,11,11,11,11,11,11,11,11,11,11,11,11,11,11,11,11,
        11,11,11,11,11,11,11,11,11,11,11,11,11,11,11,11,11,11,11,11,11,11,11,11,
        11,11,11,11,11,11,11,11,11,11,11,11,11,11,11,11,11,11,11,11,11,11,11,11,
        11,11,11,11,11,11,11,11,11,11,11,11,11,11,11,11,11,11,11,11,11,11,11,11,
        11,11,11,11,11,11,11,11,11,11,11,11,11,11,11,11,11,11,11,11,11,11,11,11,
        11,11,11,11,11,11,11,11,11,11,11,11,11,11,11,11,11,11,11,11,11,11,11,11,
        11,11,11,11,11,11,11,11,11,11,11,11,11,11,11,11,11,11,11,11,11,11,11,11,
        11,11,11,11,11,11,11,11,11,11,11,11,11,11,11,11,11,11,11,11,11,11,11,11,
        11,11,11,11,11,11,11,11,11,11,11,11,11,11,11,11,11,11,11,11,11,11,11,11,
        11,11,11,11,11,11,11,11,11,11,11,11,11,11,11,11,11,11,11,11,11,11,11,11,
        11,11,11,11,11,11,11,11,11,11,11,11,11,11,11,11,11,11,11,11,11,11,11,11,
        11,11,11,11,11,11,11,11,11,11,11,11,11,11,11,11,11,11,11,11,11,11,11,11,
        11,11,11,11,11,11,11,11,11,11,11,11,11,11,11,11,11,11,11,11,11,11,11,11,
        11,11,11,11,11,11,11,11,11,11,11,11,11,11,11,11,11,11,11,11,11,11,11,11,
        11,11,11,11,11,11,11,11,11,11,11,11,11,11,11,11,11,11,11,11,11,11,11,11,
        11,11,11,11,11,11,11,11,11,11,11,11,11,11,11,11,11,11,11,11,11,11,11,11,
        11,11,11,11,11,11,11,11,11,11,11,11,11,11,11,11,11,11,11,11,11,11,11,11,
        11,11,11,11,11,11,11,11,11,11,11,11,11,11,11,11,11,11,11,11,11,11,11,11,
        11,11,11,11,11,11,11,11,11,11,11,11,11,11,11,11,11,11,11,11,11,11,11,11,
        11,11,11,11,11,11,11,11,11,11,11,11,11,11,11,11,11,11,11,11,11,11,11,11,
        11,11,11,11,11,11,11,11,11,11,11,11,11,11,11,11,11,11,11,11,11,11,11,11,
        11,11,11,11,11,11,11,11,11,11,11,11,11,11,11,11,11,11,11,11,11,11,35,11,
        11,11,11,11,11,11,11,11,11,11,11,11,11,11,11,11,11,11,11,11,11,11,99,11
    ],
    "blockLayer": [
        30,10,30,30,30,30,30,30,30,30,30,30,30,30,30,30,30,30,30,30,30,30,30,30,
        30,10,10,10,10,30,90,10,10,10,10,10,30,10,10,10,10,10,10,30,90,10,10,30,
        30,10,30,30,10,30,30,30,30,30,30,10,30,10,10,10,10,10,10,30,30,30,10,30,
        30,10,30,22,10,10,10,30,55,10,10,10,30,10,10,10,90,10,10,10,10,30,10,30,
        30,10,30,30,30,30,10,30,10,30,30,30,30,30,10,30,30,30,30,30,10,30,10,30,
        30,20,10,10,10,10,10,10,10,10,10,10,20,30,10,10,10,10,10,56,10,10,10,30,
        30,30,30,30,30,30,30,30,30,30,10,30,30,30,30,30,10,30,30,30,30,30,10,30,
        30,10,10,10,10,10,10,30,10,10,10,10,10,10,10,30,10,10,10,10,10,10,10,30,
        30,10,10,10,10,10,10,30,10,30,30,30,30,30,10,30,30,30,30,30,30,30,10,30,
        30,10,10,10,10,10,10,10,10,10,10,30,10,10,10,10,10,10,10,30,10,10,10,30,
        30,30,30,30,10,30,30,30,30,30,10,30,10,10,10,10,10,10,10,30,10,30,30,30,
        30,10,10,10,10,10,10,30,10,10,10,30,10,10,22,10,10,10,10,10,10,10,10,30,
        30,10,30,30,30,30,10,30,10,30,30,30,10,10,58,10,10,10,10,30,30,30,10,30,
        30,10,90,30,20,10,10,30,10,10,10,30,30,30,30,30,30,30,30,30,10,10,10,30,
        30,30,30,30,30,30,10,30,30,30,10,10,10,10,10,10,10,10,10,10,10,30,30,30,
        30,10,10,10,10,10,10,30,10,10,10,30,30,30,30,30,10,30,30,30,30,30,20,30,
        30,10,30,30,30,30,30,30,10,30,30,30,10,10,90,30,10,10,10,10,10,30,10,30,
        30,90,10,10,57,10,10,10,10,10,10,10,10,30,30,30,30,30,30,30,10,59,90,30,
        30,30,30,30,30,30,30,30,30,30,30,30,10,10,10,10,10,10,20,30,10,30,30,30,
        30,10,10,10,10,10,10,30,10,10,10,30,30,30,30,30,10,30,30,30,10,30,90,30,
        30,10,10,10,10,10,10,30,10,30,10,10,90,30,20,30,10,10,10,30,10,30,10,30,
        30,10,22,10,10,10,10,30,10,30,30,30,30,30,10,30,30,30,10,30,10,10,10,30,
        30,10,10,10,10,10,10,10,10,10,10,10,10,10,10,10,10,10,10,30,10,30,36,30,
        30,30,30,30,30,30,30,30,30,30,30,30,30,30,30,30,30,30,30,30,30,30,10,30
    ],
    "meta": {
        "author": "Oscar",
        "mapName": "Level 1",
        "fileName": "level_1.json",
        "created": "2026-01-15 @11:04:00",
        "height": 24,
        "width": 24,
        "lastDoor": 550,
        "lightsOut": 0,
        "timeLimit": 1
    }
}